7,0,7,twfi75 (小揚揚),[問卦] 台灣有新創大騙局類似的案例嗎,Sun Jul  3 10:42:27 2022
66,8,58,kimura0701 (一天要喝3千cc的水),[問卦] 田馥甄剛剛在開黃腔嗎,Sat Jul  2 23:46:46 2022
20,4,16,McKen (小鮮肉),[問卦] 金曲獎的歌一首都沒聽過該怎麼辦,Sat Jul  2 23:44:30 2022
6,4,2,kll95 (Halflife),[問卦] 牙縫蛀是威力最強的蛀牙嗎,Sun Jul  3 03:36:17 2022
27,0,27,zkowntu (冰楓冷雁),Re,Sat Jul  2 23:32:00 2022
1,10,-9,Lex4193 (3+1?),Re,Sun Jul  3 08:30:36 2022
7,2,5,gishileh (三結義市xx局長下台!),[問卦] 未來直接人造人 能否一次解決所有問題?,Sun Jul  3 11:30:47 2022
2,2,0,yangyy2 (Ian),[問卦] 有辦法開一家所有飲料店熱賣品的店嗎,Sun Jul  3 08:59:10 2022
6,8,-2,ppp123 (3p哥),[問卦] 八年級比七年級優秀許多的八卦？,Sun Jul  3 08:42:42 2022
5,6,-1,KINMENKING (亂世狂刀),Re,Sat Jul  2 23:22:08 2022
5,0,5,matsui1007 (一願夢成真),Re,Sun Jul  3 11:10:00 2022
6,1,5,manhaspen (男人有筆),[問卦] 最萬用的口號是什麼？,Sat Jul  2 23:23:11 2022
6,1,5,orze04 (orz),[問卦] 全家的長榮聯名商品誰在買的?,Sun Jul  3 07:39:53 2022
32,5,27,PPPa (3P),[問卦] 台中的薪資中位數怎那麼低？,Sun Jul  3 09:34:30 2022
16,1,15,cutiehoneyzu (McHilo),[問卦] 在日本住飯店真的很容易撞鬼嗎？？,Sat Jul  2 23:08:24 2022
4,1,3,KennethC (Smith),Re,Sun Jul  3 00:53:05 2022
14,11,3,realtw (realtw良心說 不比臺灣女),Re,Sun Jul  3 09:03:42 2022
13,4,9,hoyumi (正版型男...無誤!!!),[新聞] 陳其邁Po圖讓大家猜猜要去哪裡? 網友歪,Sun Jul  3 00:09:06 2022
13,2,11,deathbead (小艾),[問卦] 被酒駕撞死的法官,Sun Jul  3 09:57:20 2022
6,0,6,eddy12357 (撾撾),[問卦] 球隊的前2大王牌同時轉隊怎麼辦？,Sun Jul  3 05:46:13 2022
2,1,1,qq0101889 (Morning9487),[問卦] 為啥馬念先會被叫做馬尿ㄚ？,Sun Jul  3 00:24:44 2022
4,3,1,aabbcc520 (U質文),[問卦] 我媽打電話來問我股票賠錢有錢吃飯嗎,Sun Jul  3 09:56:21 2022
25,2,23,danielwangdd (迪克),[問卦] 欸欸欸騎機車去宜蘭走哪條路好,Sun Jul  3 03:04:45 2022
2,1,1,xzcb2008 (可愛老娘變態貓貓=.=),Re,Sun Jul  3 10:09:12 2022
23,3,20,pinkowa (pinkowa),[問卦] 前端、後端、運維 這三個會想學哪一個?,Sun Jul  3 08:48:02 2022
213,83,130,lovea (lovea),[問卦] 香港本來就中國的，那當初在撐三小www,Sun Jul  3 10:10:26 2022
2,1,1,micheal59 (Pohan),[問卦] 現在還有在使用吹箭嗎？,Sat Jul  2 23:46:52 2022
3,0,3,mimistar (mimistar),[問卦] 鼻咽拭子有在賣嗎,Sun Jul  3 01:42:34 2022
2,0,2,SSZZ77 (甲殼類過敏),[問卦] 天氣熱是吃油膩還是清爽？,Sun Jul  3 02:10:27 2022
7,0,7,Emerson158 (紅豆 X 八嘎 X 烏魯賽),"[問卦] 吃乾麵類泡麵,會把水瀝乾嗎?",Sun Jul  3 02:22:51 2022
1,0,1,ralfeistein (無名的ㄈㄓ王),[新聞] 影／20顆造型球噴焰起飛 遊客熬夜佔位看,Sat Jul  2 23:57:36 2022
9,3,6,cj4385283 (Linhi),[問卦] 狗如果沒臭味是不是屌打貓,Sun Jul  3 11:01:31 2022
7,4,3,Chungptt (酷賈),,
1,0,1,leoamyp4 (leoamyp4),Re,Sun Jul  3 03:07:18 2022
19,2,17,remora (remora),Re,Sun Jul  3 10:30:58 2022
1,2,-1,devidevi (凱特),Re,Sat Jul  2 23:13:21 2022
5,0,5,Hanedas (),[問卦] 三金裡面是不是只剩金曲會有中國人？,Sat Jul  2 23:45:40 2022
6,1,5,ha3810996 (微八嘎囧),[新聞] 蜜蜂壞壞房子蓋在這 網友笑噴「偉人變成,Sat Jul  2 23:47:18 2022
10,3,7,kerkerson (高處不勝寒),[問卦] 滴妹會羨慕ELVA蕭亞軒嗎???,Sat Jul  2 23:23:01 2022
2,0,2,johanLarson (Rent),Re,Sun Jul  3 00:15:55 2022
2,2,0,bbsids (迷上這樣的味道),Re,Sun Jul  3 11:09:01 2022
3,1,2,amertazer (唉~~沒他色),Re,Sat Jul  2 23:49:59 2022
486,96,390,monine (),[新聞] 不會用藍芽！師大教授千字文控店員態度差,Sun Jul  3 08:31:06 2022
0,0,0,Kashionz (空阿哭啊Peko),Re,Sun Jul  3 03:43:54 2022
5,0,5,lienchi (...),[問卦] 為什麼有人怕手機基地台大過陽光？,Sun Jul  3 09:50:32 2022
54,5,49,leocean9816 (阿光),[新聞] 陸三大航空訂購292架空巴 波音：令人失望,Sun Jul  3 00:27:48 2022
0,0,0,o523874 (就買一個感覺),Re,Sun Jul  3 11:22:13 2022
7,3,4,TomFord5566 (湯福56),[問卦] 歐洲人會羨慕美國那麼強嗎？,Sun Jul  3 11:13:17 2022
5,0,5,rikey0214 (0.0),[問卦] 手機扔在床上睡著會怎樣？,Sun Jul  3 11:03:35 2022
33,2,31,HDSM (Love Not Change  O'_'O),[問卦] 看過『機械女神』的幾歲了阿？,Sun Jul  3 00:59:06 2022
6,2,4,whiteadam (blue eyes blue),[問卦] 溫嵐跟elva誰有整形過??,Sun Jul  3 01:55:13 2022
1,1,0,tok892xt7 (優質廢文),[問卦] 我聽聞 妳始終一個人？,Sat Jul  2 23:08:53 2022
1,0,1,HDSM (Love Not Change  O'_'O),[問卦] 今天 又是雨時多雲偶陣晴,Sun Jul  3 00:50:42 2022
10,3,7,Lime5566 (萊姆56),[問卦] 以前人會把音樂放到光碟裡面來聽?,Sat Jul  2 23:25:03 2022
1,0,1,sam810626 (Sam),[問卦] 大家有沒有要報考今年的國營聯招啊?,Sat Jul  2 23:09:08 2022
7,3,4,fcugeo (fcugeo1746),[問卦] 今天金曲獎得獎的專輯你買了幾張？,Sun Jul  3 00:17:18 2022
0,4,-4,emperor (派蘿派蘿得第一),[問卦] 喜歡的女生變女王會不會後悔沒把她?,Sat Jul  2 23:52:03 2022
7,0,7,jerome2010 (636237),[問卦] 有什麼辦法可以休假唸書準備國考,Sun Jul  3 08:24:56 2022
11,2,9,sodistrues (true),[問卦] 日本男優小栗旬為什麼能紅那麼久？,Sun Jul  3 08:22:22 2022
242,13,229,neo19 ((づ′・ω・）づ),[問卦] 蕭亞軒的鼻子怎摸了,Sat Jul  2 23:17:33 2022
7,0,7,kuangjc5566 (匡匡56),[問卦] 有沒有崔健 假行僧這首歌的八卦,Sat Jul  2 23:58:40 2022
4,0,4,lienchi (...),[問卦] 手機真的不能放口袋嗎,Sun Jul  3 00:02:28 2022
11,0,11,jonjes (HONOKA),[問卦] 怎麼久坐電影院的椅子,Sun Jul  3 05:31:03 2022
8,3,5,fickleness (小舞揭),[問卦] 我的NETFLIX現在 不能看，你的能看嗎？,Sun Jul  3 09:47:21 2022
2,2,0,wuyiulin (龍破壞劍士巴斯達_客家人),[問卦] 生活的價值總是來自於充滿挫折的經歷？,Sun Jul  3 02:15:04 2022
7,1,6,AlainDelon (無心睡眠),Re,Sun Jul  3 03:03:31 2022
5,0,5,gyGirl (妹),Re,Sun Jul  3 09:58:58 2022
2,0,2,freddy60907 (happysexyday),[問卦] 萬葉可莉 都幾,Sat Jul  2 23:11:33 2022
5,6,-1,x941u4vu86 (x94),[問卦] 滴妹何時要回台灣？,Sun Jul  3 09:48:21 2022
3,0,3,KevinLow (廢文漏),[問卦] 灰,Sat Jul  2 23:13:56 2022
1,3,-2,tok892xt7 (優質廢文),[問卦] 發現自己的歌單一堆抖音歌怎麼辦,Sat Jul  2 23:46:57 2022
2,2,0,zzzz8931 (宅男),[新聞] 「悲憤的七一」 港人在紐約時代廣場抗議,Sun Jul  3 00:09:09 2022
42,5,37,sushi11 (偶像可以亂摸嗎peko),[問卦] 對岸脫口秀明明不好笑，為什麼要假笑？,Sun Jul  3 09:15:39 2022
3,9,-6,todao (心裡有數),Re,Sun Jul  3 01:18:07 2022
16,1,15,Kakehiko (用localizer晾衣服),[問卦] 先秦時代的姓氏名,Sun Jul  3 07:42:23 2022
2,1,1,Su22 (裝配匠),[新聞] 騰訊與字節跳動再裁員 上海穩就業措施遭,Sat Jul  2 23:57:07 2022
5,1,4,sky0302 (free),Re,Sun Jul  3 01:31:15 2022
18,5,13,onesweetday (onesweetday),[問卦] 蔡健雅到底多會唱歌？,Sun Jul  3 00:29:53 2022
10,1,9,eddie5689 (),[問卦] 張惠妹是不是蓄勢待發了？,Sat Jul  2 23:25:16 2022
2,0,2,hyperdunk (別鞭我),[問卦] 選一首金曲獎歌曲去參加葛萊美？,Sun Jul  3 09:56:44 2022
25,4,21,seand8088503 (あいうえお),[問卦] 八卦板最推的入門紅酒是哪支？,Sun Jul  3 11:47:38 2022
14,0,14,rockman1118 (玉骨冰心沐流塵),Re,Sun Jul  3 00:56:54 2022
8,5,3,ccyaztfe (1357924680),[問卦] 對面六費挑戰者，七費爆爆，八費佛丁？,Sun Jul  3 08:38:28 2022
3,1,2,oz5566 (阿萊克修斯),Re,Sun Jul  3 09:17:07 2022
4,4,0,JiaTai (J.T.),[問卦] 哪一年才不是最糟的一年？,Sun Jul  3 08:25:15 2022
15,1,14,Sylph (炁+盆滿缽滿),[問卦] 台灣人有發現英文資訊的品質比中文高嗎？,Sun Jul  3 11:52:24 2022
5,4,1,P00832129 (微妙),Re,Sun Jul  3 09:25:04 2022
47,19,28,words2012 (づ′・ω・),"[問卦] 崔健為什麼拿最佳男歌手,根本沒聽過",Sun Jul  3 02:44:05 2022
4,0,4,chinaeatshit (我愛台灣！中國吃屎！！),Re,Sun Jul  3 11:23:55 2022
9,2,7,Hsins (迅雷不及掩耳盜鈴),[問卦] 燒香燒了兩短一長？,Sun Jul  3 00:24:23 2022
11,0,11,Tosca ( ),[問卦] 紅白機Top Gun有人成功降落航母過嗎?????,Sun Jul  3 10:51:36 2022
2,4,-2,ashow (修~(￣▽￣)~(＿△＿)~),[問卦] 讀進化論 我贊成達爾文?,Sun Jul  3 00:25:57 2022
10,14,-4,realtw (realtw良心說 不比臺灣女),[問卦] 崔健是臺灣金曲獎強行幫他報名嗎？,Sun Jul  3 09:40:45 2022
5,0,5,rdu20159 (RDU),[問卦] 鴿子的國旗,Sun Jul  3 10:49:50 2022
7,0,7,kotori0723 (百發get),[問卦] 中國颱風天還出工程船蓋風電,Sun Jul  3 07:45:06 2022
0,0,0,ptt987654321 (大谷躺平),Re,Sun Jul  3 11:44:11 2022
11,5,6,oz5566 (阿萊克修斯),[問卦] 假如重機可以上國道 但是要簽生死狀,Sun Jul  3 10:32:05 2022
11,1,10,s910 (s910),[問卦] Acut跟教父誰才是牛排界王者?,Sat Jul  2 23:51:29 2022
1,0,1,Sevorlaga (【斯佛拉加】。),Re,Sun Jul  3 08:55:10 2022
13,0,13,ZengMaktub (YOYOMAK),[問卦] 只有周杰倫能超越統獨議題？,Sun Jul  3 08:42:50 2022
11,8,3,fcugeo (fcugeo1746),[新聞] 黃連煜奪金曲評審團獎 高喊「所有人都是,Sat Jul  2 23:56:02 2022
1,3,-2,op840906 (LOVEISFOURLETTERSWORS),[問卦] 房價跌了，可是你在社會的PR不變，買得,Sun Jul  3 10:36:18 2022
2,0,2,T3T (G.S.M.W),Re,Sun Jul  3 08:58:31 2022
5,2,3,dinhan (ChuChu),[問卦] 為什麼台南一堆店家都沒有冷氣,Sat Jul  2 23:15:09 2022
84,58,26,jeipurple (Ariel),[新聞] 年輕人轉向了？蔡英文最新民調嚇死人 網,Sun Jul  3 08:11:55 2022
2,3,-1,Rasin (雷森),[問卦] 為什麼昆蟲那麼聰明?,Sun Jul  3 06:39:12 2022
3,0,3,hoyumi (正版型男...無誤!!!),[問卦] 五燈獎闖關成功的人唱歌有多強？,Sun Jul  3 10:02:30 2022
4,2,2,KhePri (史密提威威),[問卦] 欸！你們有吃過筍豆嗎？,Sun Jul  3 00:16:05 2022
29,10,19,nightwinded (Night Wind),[問卦] 把藍牙打成藍芽都哪種人？,Sun Jul  3 10:29:34 2022
10,0,10,com2 (),Re,Sun Jul  3 11:28:58 2022
4,7,-3,abc1204 (         ),[新聞] 出國人數飆3倍！入境放寬4萬人最快本週,Sun Jul  3 11:39:44 2022
24,7,17,lovea (lovea),[新聞] 1歲女嬰高燒送醫遇塞車　桃園警鳴笛開道4,Sun Jul  3 10:48:10 2022
7,0,7,howard24 (中信兄弟強攻強攻),[問卦] 茄子蛋怎麼唱出89歌的?,Sun Jul  3 00:02:46 2022
27,3,24,nyabinghi (Nyabinghi),[問卦] 誰投擲手榴彈能贏打棒球的？,Sun Jul  3 10:53:00 2022
3,0,3,saobox (刀劍神域盒盒),[問卦] 我朋友想偷博物館的大鑽石 有可能成功嗎?,Sat Jul  2 23:15:05 2022
3,3,0,david3809 (霜月薰),[問卦] 周杰倫根本是鬼吧？,Sat Jul  2 23:31:40 2022
2,0,2,godbar (乳不巨何以聚人心),Re,Sun Jul  3 10:03:04 2022
9,6,3,Supasizeit (更大更快更有力),[問卦] iTunes 排行榜是不是最準,Sun Jul  3 01:08:34 2022
3,0,3,a22028504 (王),[問卦] 如何增加社會經濟底層的消費能力呢?,Sun Jul  3 10:55:29 2022
3,2,1,bluebagel (果果:)),[問卦] 立榮根本狂勝華信？,Sat Jul  2 23:54:02 2022
3,0,3,twmadrid (chrissy我老婆),Re,Sun Jul  3 10:05:02 2022
38,15,23,kanjiya (貓豬豬),[問卦] 台灣人怎不敢讓小學生自己上學回家,Sun Jul  3 09:06:12 2022
3,0,3,ms0286415 (叫我網路作家就好),[問卦] 有推荐不刺激不過敏的洗面乳嗎??,Sun Jul  3 00:42:22 2022
155,25,130,DarkHolbach (垃圾),Re,Sat Jul  2 23:19:37 2022
1,0,1,kenq5566 (肯Q),[問卦] 看金曲獎的人跟看原神2.8前瞻的人誰多,Sun Jul  3 10:56:01 2022
5,2,3,cyh2210 (有完沒完?),[問卦] 請問為何我ig很多韓國妹子帥哥？,Sun Jul  3 09:44:20 2022
2,1,1,onepunchgg (GurA守護者),[問卦] 把圖畫成這樣神得到原帳號嗎,Sun Jul  3 09:57:17 2022
0,0,0,ppp123 (3p哥),[問卦] 單車併排聊天不怕被撞喔？,Sun Jul  3 08:14:41 2022
13,4,9,Scathach (沙花叉クロヱの旦那様),[問卦] 喉嚨感覺快斷ㄌ= =,Sun Jul  3 11:41:32 2022
10,0,10,sushi11 (偶像可以亂摸嗎peko),[問卦] 有人知道阿Q臭臭鍋怎麼消失的嗎？,Sat Jul  2 23:52:17 2022
74,29,45,ICEN (冰),[問卦] 珂拉琪是不是台灣YOASOBI,Sun Jul  3 02:12:50 2022
1,2,-1,G2S (越接近夕陽影子越長),[問卦] 比悲傷更悲傷的事裡牙醫是最悲傷的角色嗎,Sun Jul  3 01:25:21 2022
60,3,57,jp6vu04boy (客家肥肥),[問卦] 怎麼很多人認為「亂開車=技術好」？,Sun Jul  3 07:29:03 2022
3,30,-27,Tiara5566 (霸凌天團),[新聞] 蔡阿嘎曝光「二伯」綽號由來！網驚：不是,Sat Jul  2 23:58:00 2022
6,1,5,a0a000000000 (...),Re,Sun Jul  3 09:36:04 2022
1,1,0,metallican (鋼鐵人),[問卦] 木曜怎麼大多都在吃東西,Sun Jul  3 10:46:54 2022
14,4,10,wantorgasm (午後的相遇),[問卦] 現在獨立樂團反而變成主流了吧,Sun Jul  3 09:26:19 2022
48,3,45,Ayanami5566 (綾波五六),[問卦] 不經思考 第一個想到的非洲人是誰??,Sat Jul  2 23:23:34 2022
7,2,5,maggie024 (莫莉),[問卦]  大牛主持是不是自己撐不住,Sun Jul  3 11:30:42 2022
3,0,3,CahoForever (Forever),[問卦] 大家能用剪指甲的刀，拿來剪頭髮嗎???,Sun Jul  3 03:39:03 2022
6,1,5,IMBA5566 (許孟哲),[問卦] Elva蕭亞軒的鼻子怎麼了？,Sat Jul  2 23:18:12 2022
3,0,3,Savior09 (Sakana Mazui),Re,Sat Jul  2 23:28:23 2022
11,2,9,TPDC ()(),[新聞] 大一新生人數 首度超過高中應屆生,Sun Jul  3 11:16:54 2022
104,12,92,zakijudelo (Zack),[新聞] 「民進黨靠假新聞騙人民！」　她揪3件事,Sat Jul  2 23:49:12 2022
5,2,3,flyuhigh (第壹參壹貳屆臺大最速男),[問卦] 欸！等等考日檢但突然想大便啦,Sun Jul  3 11:53:17 2022
3,0,3,nissan168 (pingGO),[問卦] 孔孟如果選制度會選美國的制度嗎？,Sun Jul  3 00:43:34 2022
8,8,0,sdtgfsrt (カヴァスⅡ世),[問卦] 警察怎麼不把那些國道重機槍斃？,Sun Jul  3 11:10:23 2022
60,191,-131,sincere77 (台灣會更好),[新聞] PTT有人對烏俄戰爭抱持投降主義 綠委要求,Sun Jul  3 10:49:42 2022
7,1,6,voohong (SE Asia Fat Nerd),[問卦] 為什麼都沒發明自動運動機？,Sun Jul  3 09:10:24 2022
11,0,11,dennistao (不住心齋橋的心齋橋哥),[問卦] 其實PS5是被遊戲店家自己炒壞的吧?,Sun Jul  3 10:50:48 2022
28,5,23,micheal59 (Pohan),[新聞]  羅時豐送小孩棒棒糖「給你沒戴套的」!開,Sun Jul  3 00:19:50 2022
7,17,-10,thelittleone (うそつき),[新聞] 陸外交部嗆北約：不會任由別人把亞太搞亂,Sun Jul  3 10:28:20 2022
12,3,9,epiphyte (晴),[問卦] 廣仲的髮量是不是讓眾多男性羨慕,Sun Jul  3 00:42:37 2022
0,0,0,yokann ( ),[問卦] 蝦皮白金蝦還有啥用？,Sun Jul  3 11:49:13 2022
2,0,2,Qorqios (塔の魔女⊕﹏⊕‼),[問卦] 可以去蔡老闆面前拍桌嗎？,Sun Jul  3 00:14:10 2022
0,0,0,jimmy880921 (張開腿說不),[問卦] 有沒有可以強化通知的app啊,Sat Jul  2 23:46:15 2022
10,2,8,YU0121 (愛玉冰™),Re,Sun Jul  3 01:01:29 2022
4,0,4,ltyintw (菈米雅嘶嘶),Re,Sun Jul  3 07:37:26 2022
6,5,1,fack3170 (法克),[問卦] 金曲獎最多的男人？,Sun Jul  3 01:41:16 2022
233,1,232,Nigger5566 (尼哥56),Re,Sun Jul  3 00:52:03 2022
6,0,6,KitsuneNeko (狐貓),Re,Sat Jul  2 23:21:58 2022
6,0,6,koushimei (平安順心),Re,Sun Jul  3 11:23:27 2022
4,1,3,Ommmmmm5566 (有人責備我們不夠深入),Re,Sun Jul  3 00:24:21 2022
192,8,184,ashow (修~(￣▽￣)~(＿△＿)~),[問卦] 不經思考 第一首想到蔡健雅的歌？,Sun Jul  3 00:01:44 2022
4,3,1,Ericz7000 (),[問卦] 有人會忘記洗澡嗎,Sun Jul  3 08:48:39 2022
8,5,3,jiern (jiern),Re,Sun Jul  3 09:10:11 2022
8,2,6,became (windim),[問卦] 如何在第一次傳訊息給對方不犯跟騷法呢,Sun Jul  3 09:11:46 2022
3,2,1,oz5566 (阿萊克修斯),[問卦] 重機 台女 甲甲 怎摸都那摸愛吃自助餐,Sun Jul  3 10:55:39 2022
77,14,63,hTCU11 (Squeeze),[新聞] 西門町火紅「泰國店」13歲少女陪酒「100,Sun Jul  3 01:48:49 2022
0,0,0,sinohara (kinu),Re,Sun Jul  3 00:09:22 2022
4,0,4,Articuno (水噹噹),[新聞] 車庫改裝芭比展示間 珍藏芭比娃娃天天欣賞,Sat Jul  2 23:47:14 2022
6,0,6,anomic24 (若彧),[問卦] 戲水的人都不怕水髒嗎,Sun Jul  3 11:38:21 2022
106,29,77,Gazooli (阿爾敏·亞魯雷特),[問卦] 重機在國道摔車會怎麼樣？,Sun Jul  3 10:18:11 2022
7,5,2,thelittleone (うそつき),[問卦] 台灣國際觀是不是太偏頗了？,Sun Jul  3 11:21:24 2022
14,3,11,bathilda (bat),Re,Sun Jul  3 01:32:03 2022
9,3,6,GAP5566 (User),[問卦] 女人對男人說你‘’搞怪‘’的地方很多,Sun Jul  3 09:28:35 2022
9,0,9,skn60694 (入聲),[問卦] 穿素Polo衫紮西裝褲被笑 如何處置?,Sun Jul  3 09:14:52 2022
5,1,4,andrewmiho (愛喝啤酒),[問卦] 高速公路無差別開放車輛有沒搞頭？,Sun Jul  3 09:16:26 2022
1,0,1,lucifa38 (夢中與誰相見),Re,Sun Jul  3 08:38:08 2022
17,46,-29,ptt987654321 (大谷躺平),[新聞] 好市多衛生紙漲價!會員崩潰 王浩宇驚喊,Sun Jul  3 08:35:09 2022
3,0,3,seysem (seysem),Re,Sun Jul  3 01:27:55 2022
0,0,0,toofat (南勢角野郎哥),[問卦] 為什麼翻譯成最偉大的命中？,Sun Jul  3 00:32:51 2022
4,7,-3,aventardorsv (lamborghini aventadorsv),[問卦] 正妹是在吃醋嗎?,Sun Jul  3 00:49:19 2022
0,0,0,ubcs (覺★青年超冒險蓋),[公告] 八卦板板規(2022.02.21),Mon Feb 21 23:04:30 2022
11,60,-49,WorkinChina (WIC),[新聞] 轉型正義座談 范雲:完整真相才有真正信,Sun Jul  3 11:29:18 2022
0,0,0,tom501062003 (池袋情報商),[問卦] 一千元上的小朋友現在在幹嘛？,Sun Jul  3 12:00:06 2022
12,10,2,fcugeo (fcugeo1746),[新聞] 環團自製「塑膠福利熊」 呼籲全聯減塑,Sun Jul  3 00:05:58 2022
32,10,22,subcrew (Working Below The Hype),[問卦] 重機上國道遇到超級暴雨會怎樣,Sun Jul  3 11:04:06 2022
12,7,5,asd245438 (不要問，一切都是幻影~),[新聞] 跨部會齊推充電樁設置 為電動車普及化鋪,Sat Jul  2 23:16:35 2022
0,0,0,s001582000 (洨軒),Re,Sun Jul  3 11:51:17 2022
10,17,-7,GrimmNotes (),[新聞] 劉樂妍情緒潰堤！悲喊「老天爺殘忍」：,Sun Jul  3 10:09:39 2022
0,1,-1,kaky (菩提本無樹明鏡亦非台),Re,Sun Jul  3 01:04:27 2022
11,6,5,Inkdust (凡),[新聞] 14歲少女得知大學男友劈腿 自曝曾經啪,Sun Jul  3 10:04:53 2022
61,8,53,a0a000000000 (...),[新聞] NASA署長示警 小心中國登月佔領月球,Sun Jul  3 08:45:51 2022
8,2,6,XBOXFANS (man),[新聞] 福原愛遭抵制仍照上各類節目 電視台製作,Sun Jul  3 08:57:50 2022
0,0,0,a245065789 (PDA),[問卦] 今天去殺139縣道 怎警察特多,Sun Jul  3 11:57:29 2022
9,1,8,KKKKKvs333 (NOW_EMPiRE),[問卦] 劉若英的哪首歌最好？,Sun Jul  3 08:32:30 2022
7,3,4,BigCockman (大雕男),[問卦] 老人學不會新科技的原因是什麼？,Sun Jul  3 11:43:23 2022
7,3,4,P0GUY (仆街~~~~~),[問卦] 各位有聽完任何一張去年發的專輯嗎,Sun Jul  3 09:59:48 2022
10,0,10,afacebook (A臉書),[問卦] 中國人為什麼要自己蓋艾菲爾鐵塔?,Sat Jul  2 23:36:46 2022
0,3,-3,mono5566 (優雅氣質不反串),[問卦] 貓貓一直不肯走,Sat Jul  2 23:16:27 2022
32,7,25,kidtoo (我看你完全是不懂喔),[問卦] 為什麼台灣 對8+9文化這麼買單？,Sun Jul  3 00:06:09 2022
7,11,-4,OPPAISuki (OPPAISuki),[問卦] 有人聽過 蔡健雅 這張專輯的嗎? +1,Sun Jul  3 00:05:13 2022
7,1,6,bathilda (bat),[問卦] 整形不會自己審查一下結果嗎？,Sun Jul  3 03:41:46 2022
7,1,6,Townshend (Pete),[問卦] 很多老人都走了 勞健保壓力是否減輕很多?,Sun Jul  3 10:19:02 2022
12,2,10,songgood (ilovegoodgame),[問卦] 蔡桃貴和晨晨怎差這麼多,Sun Jul  3 11:01:21 2022
14,2,12,kinjk01 (小白),[問卦] 會吸毒的人不能相信？,Sun Jul  3 02:09:04 2022
3,3,0,a493103terry (就是這麼惠),[問卦] 怎麼跟半年沒聯絡的教授打招呼,Sun Jul  3 10:36:10 2022
0,0,0,cutiehoneyzu (McHilo),[問卦] 爲什麼玩股票錢賠越多 身體會越腫？？,Sun Jul  3 11:55:06 2022
0,0,0,PCclean (BOBO),Re,Sun Jul  3 07:29:50 2022
5,4,1,drakd4d (NULL),[問卦] 金曲獎頒獎 陶喆 周杰倫跑去哪了？,Sun Jul  3 01:50:46 2022
8,0,8,wpd (??),[問卦] 台灣會流行起安全帽印上自己封號嗎??,Sun Jul  3 02:56:59 2022
0,2,-2,Qorqios (塔の魔女⊕﹏⊕‼),Re,Sun Jul  3 01:02:38 2022
8,1,7,p25488148 (一定愛用挖ㄟ馬吉呀米),[問卦] 為啥被大學長撞的小客車不用負全責啊,Sun Jul  3 09:43:46 2022
0,0,0,juyhnmki (juyhnmki),[問卦] 不用漱口杯的人多嗎？,Sun Jul  3 11:58:52 2022
2,1,1,kelvintube (strike-out),[問卦] 有金曲最佳女歌手的八卦嗎？,Sat Jul  2 23:36:31 2022
6,0,6,nk11208z (小魯),[問卦] 每年的KKBOX風雲榜才是真正的金曲獎吧,Sun Jul  3 00:14:13 2022
0,0,0,Lefteye (利傅艾),Re,Sun Jul  3 08:42:19 2022
7,1,6,cailon (我不一定是我!),[問卦] 原來已經暑假了,Sat Jul  2 23:29:39 2022
2,3,-1,laugh8562 (laugh8562),[問卦] 這個人怎麼在水上移動的?,Sun Jul  3 11:15:32 2022
2,6,-4,miloskyman (削波快),[問卦] 今年的金曲是不是在分豬肉,Sun Jul  3 00:33:52 2022
12,4,8,opemhood (大漢堡),[問卦] 為了民主自由，獨裁也是必要的一環吧？,Sat Jul  2 23:14:01 2022
12,5,7,meta41110 (阿標),[新聞] 高通膨、失業增 痛苦指數飆,Sun Jul  3 11:08:13 2022
132,43,89,george303 (ASICS),[新聞] 爭取路權！大型重機騎上國道「遍地開花,Sun Jul  3 08:22:06 2022
3,2,1,ffdqfe (苦惱),[問卦] 為什麼不能優雅的老去？,Sun Jul  3 02:40:20 2022
17,7,10,parkinque (英文老師),Re,Sat Jul  2 23:48:11 2022
97,11,86,rexlin (Some like it hot!!),[新聞] 長照悲歌！拿菜刀砍頸殺阿嬤 思覺失調孫,Sun Jul  3 03:10:49 2022
10,2,8,thewtf (濱邊美波我老婆),[問卦] 發現日本人根本不會害怕停電（圖,Sun Jul  3 09:17:51 2022
62,23,39,cow09421 (傲嬌戰場原),[新聞] 轎車高速撞2車「保全等紅燈無辜慘死」肇,Sun Jul  3 06:58:33 2022
5,1,4,johanLarson (Rent),Re,Sun Jul  3 01:31:04 2022
4,1,3,silver0314 (吾要失態了！),[問卦] 蕭亞軒是在cos HIM嗎？,Sun Jul  3 01:42:09 2022
0,0,0,forest1538 (hcaoc),[問卦] 連鎖早餐店最頂是哪家？,Sun Jul  3 12:02:00 2022
442,17,425,Homura (德意志國防貓),[問卦] 震撼彈！上站次數變成紫色了,Sun Jul  3 00:17:37 2022
100,13,87,zkowntu (冰楓冷雁),[爆卦] 中國搖滾之父崔健獲最佳男歌手獎,Sat Jul  2 23:41:21 2022
2,0,2,BroDians (網圍包),[問卦] 某些全家便利商店是不是新舊歡迎光臨音樂都放？,Sat Jul  2 23:51:39 2022
1,1,0,ray081411 (ray),[問卦] 潮潮有在洗帽子嗎,Sun Jul  3 07:33:02 2022
40,7,33,arakiyuko (ゆんぴょ),[問卦] 抄襲歌手有資格得金曲獎嗎？,Sun Jul  3 02:00:58 2022
2,0,2,autokey (該起床啦),[問卦] 玩三國志創新武將是明星藝人是何心態?,Sun Jul  3 00:49:03 2022
10,19,-9,LoveMakeLove (0),[新聞] 悼念乙未戰爭英魂 蔡英文：客家精神就是,Sun Jul  3 10:59:11 2022
3,0,3,wade6510 (真情不必多說),Re,Sat Jul  2 23:41:08 2022
9,0,9,KennethC (Smith),[問卦] 有沒有林雪坪大學的八卦??,Sat Jul  2 23:38:16 2022
21,1,20,ivorysoap (ivorysoap),[問卦] 現在的中高學生帶什麼會成為班上紅人？,Sun Jul  3 09:08:51 2022
0,0,0,scores (男兒當逆天！),Re,Sat Jul  2 23:40:00 2022
10,6,4,fox875566 (fox9527),[問卦] 全世界石油業只有中油虧錢嗎,Sun Jul  3 09:33:12 2022
2,0,2,F16V (你姬善擠 獨門武器),[新聞] 菲採購6艘韓製近海巡邏艦 增強海上戰力,Sun Jul  3 11:17:50 2022
65,9,56,ian1107 (飛翔般的奔跑),[問卦] 蕭亞軒的代表作是什麼的卦?,Sat Jul  2 23:24:38 2022
7,2,5,murray5566 (睡覺睡到自然醒),[問卦] 趙孝成王走錯哪一步才被秦國坑殺40萬兵?,Sun Jul  3 00:11:20 2022
4,2,2,Moneygerm (熊鮪猩),[問卦]  哪個最酷,Sun Jul  3 00:17:52 2022
101,3,98,gindisergo (gindis),[新聞] 「20公分」巨型非洲蝸牛入侵美國佛州！ ,Sun Jul  3 04:34:23 2022
19,3,16,sunsam (山山姆),[問卦] QBurger 現在時間生意這樣好喔,Sun Jul  3 10:35:13 2022
8,2,6,chirex (不含銅鋰鋅),Re,Sun Jul  3 00:24:56 2022
6,1,5,aabbcc520 (U質文),Re,Sun Jul  3 11:30:28 2022
4,2,2,kohanchen (kohanchen),[問卦] 為何還沒有迴轉小菜？,Sun Jul  3 09:44:46 2022
7,1,6,Sron (讀書好嗎),[問卦] 欸靠 現在才知道眭澔平入圍過金曲是不,Sun Jul  3 02:51:51 2022
149,6,143,ubcs (覺★青年超冒險蓋),[公告] 六月份置底閒聊區,Wed Jun  8 16:40:42 2022
9,1,8,fawangching (),[問卦] 自介說自己的興趣是去八大行業玩？,Sun Jul  3 08:36:20 2022
24,14,10,Goo4u (Goo4u),[問卦] 這波股市殺盤，逼一堆人賣房補融資斷頭,Sun Jul  3 08:03:07 2022
6,7,-1,kalaokla (卡啦),"[問卦] 有沒有ptt股票版在實行""文字獄""的八卦?",Sun Jul  3 10:57:01 2022
2,3,-1,yangzy (亞瑟),[問卦] 你們有人在自家地下室埋東西嗎？,Sun Jul  3 00:05:17 2022
3,0,3,g7a7n7 (優文製造機),[問卦] 尼哥連老闆都敢歧視啦？,Sat Jul  2 23:19:59 2022
2,0,2,blue999 (FLY),Re,Sun Jul  3 00:20:20 2022
4,7,-3,generalfungi (香菇將軍),[問卦] 是不是很多人不知道蔡健雅疑似抄襲？,Sat Jul  2 23:26:59 2022
7,10,-3,assassinASHE (幹古專用帳號),[問卦] 媽媽不喜歡花車小姐...,Sun Jul  3 00:29:06 2022
1,1,0,CNseven (Maryyyyyyyy),[問卦] 這裡的夜景很有感覺,Sun Jul  3 01:41:26 2022
3,0,3,KennethC (Smith),[問卦] 燕麥奶是不是變淡了qq??,Sun Jul  3 00:34:10 2022
3,1,2,fuya101 (@@),[問卦] 長青苔是因為,Sun Jul  3 10:33:09 2022
4,1,3,henkyu (也無風雨也無晴),[問卦] 影片配樂的八卦？,Sun Jul  3 08:38:58 2022
0,0,0,mk203125 (戴奧辛),[問卦] 電池是不是懷孕了？？,Sun Jul  3 12:03:36 2022
19,1,18,chubby31190 (優文專家),[新聞] 省時縮路程有感！服務區聯外道成上國道「,Sun Jul  3 03:27:53 2022
2,5,-3,blaga (羅馬尼亞哲學家),[問卦] 吃科學麵捏 or 不捏都幾？,Sun Jul  3 00:54:51 2022
2,2,0,lightwish (穹願),[新聞] 江蘇安徽疫情升溫 民眾恐慌囤積物資,Sat Jul  2 23:25:13 2022
2,0,2,tucson (tucson),Re,Sun Jul  3 10:42:51 2022
55,6,49,ashow (修~(￣▽￣)~(＿△＿)~),[問卦] 有沒有蔡健雅拿四座金曲歌后的八卦,Sat Jul  2 23:21:32 2022
4,0,4,tth9955 (EvilHeart),[問卦] 和歌山是不是很危險 =.=|||,Sat Jul  2 23:08:53 2022
19,1,18,sole772pk37 (單推Korone),[問卦] 普通重型機車族會想上國道嗎,Sun Jul  3 11:07:43 2022
2,0,2,pptsuck (whip),[問卦] 派克諾坦這角色是參考楊謹華還是蕭亞軒?,Sun Jul  3 00:08:26 2022
4,0,4,s2678132 (重力可可),Re,Sun Jul  3 02:55:44 2022
67,7,60,KIRA1943 (大俠愛吃漢堡包),[問卦] 到底還有甚麼影集可以看啦,Sun Jul  3 11:05:23 2022
8,3,5,s1777001 (iPad溫開水),[新聞] 漁民節不開心 韓國瑜轟政府「大內宣」無,Sat Jul  2 23:17:33 2022
2,0,2,cpz (我是閃亮亮的鑽石),[問卦] 有鄉民這半年變低端的ㄇ？,Sat Jul  2 23:09:32 2022
2,3,-1,gentleman888 (),[問卦] 肥宅不爽服務態度不佳的店員要怎麼處理,Sun Jul  3 10:55:03 2022
2,4,-2,JHS (慕山駛者),[問卦] 為何會有美女愛上軟男爛男暴力男,Sun Jul  3 08:15:34 2022
10,7,3,saipipi (雷神),[問卦] 明年應該辦金曲抖音獎才對？,Sun Jul  3 08:34:30 2022
26,7,19,Ericz7000 (),[問卦] 為什麼拉麵店常常放動漫歌,Sun Jul  3 09:01:47 2022
7,4,3,aabbcc520 (U質文),[問卦] 3年又3年都過10個了怎麼還沒有女朋友八卦,Sun Jul  3 11:20:33 2022
22,1,21,WeiU (台大IU),Re,Sat Jul  2 23:26:31 2022
12,3,9,david0426 (軒軒寶貝),[問卦] 急！盔甲巨人把城牆撞破了,Sun Jul  3 00:40:30 2022
23,3,20,Dukkha (Anagami),[新聞] 斯里蘭卡是中國「債務陷阱」的受害者？,Sun Jul  3 10:20:47 2022
22,3,19,kauosong (如何一少年，匆匆已白頭),[問卦] 現在的新歌手誰有實力可以辦萬人演唱會？,Sun Jul  3 06:15:44 2022
8,4,4,Luckmeow (meow),[問卦] 直腸科醫師怎沒衛教宣導別肛交傷害肛門？,Sun Jul  3 11:40:06 2022
5,6,-1,lelena (智慧之神-透特),[問卦] 為什麼不派周子瑜solo?,Sun Jul  3 09:56:24 2022
8,2,6,Akuma5566 (塔綠班親衛隊),Re,Sun Jul  3 11:14:40 2022
1,0,1,pauljet (拜登哥不要),Re,Sun Jul  3 00:19:33 2022
7,3,4,jasd1786 (假橡膠樹),[問卦] 有沒有入圍金曲獎最輕鬆的方法？,Sun Jul  3 01:58:47 2022
9,0,9,linda17a3 (),[問卦] 陶瓷內膽保溫杯界的ez100pu是誰？,Sun Jul  3 09:05:59 2022
5,7,-2,thewtf (濱邊美波我老婆),[問卦] 速食店主管都是大奶配黑色內衣嗎,Sun Jul  3 09:02:01 2022
10,10,0,a1e (我上了賊船了囧),Re,Sun Jul  3 00:13:40 2022
4,0,4,ketter (挖西林老背),[問卦] 伍佰要改名嗎?,Sun Jul  3 08:31:26 2022
38,5,33,Beanoodle (津崎似超人平匡先生),[問卦] 不經思考第一個想到姓蔡的女性是誰？,Sun Jul  3 00:09:28 2022
4,3,1,ChuanFunker (八卦版水桶常客),[問卦] 還記得你小時候的志願嗎？,Sun Jul  3 00:35:25 2022
3,2,1,darkstar07 (高級大法師),[問卦] 8+9用滅火器幹架要如何使用?,Sun Jul  3 11:10:35 2022
10,4,6,Kimmy (Kimi),[問卦] NBA史上最衰球隊是籃網吧,Sun Jul  3 08:05:43 2022
6,0,6,kimo6414 (凡人皆有一死),[問卦] 貓會抬頭睡覺嗎,Sat Jul  2 23:09:42 2022
6,0,6,whoisanky (ノ・ω・)阿呼(・ω・ヾ),[問卦] 這是什麼蛾？,Sun Jul  3 08:55:12 2022
55,6,49,windward007 (風魔法師),[問卦] 你的金曲驚爆點是什麼？,Sun Jul  3 00:14:38 2022
22,16,6,purine5566 (漂亮56),[問卦] 其實麥當勞一直以來方針都很正確吧?,Sun Jul  3 01:08:58 2022
398,135,263,ispy03532003 (臭酸肥它),Re,Sun Jul  3 00:40:23 2022
2,2,0,sploo (貓人),[問卦] 圖書館是不是變熱,Sun Jul  3 10:26:41 2022
3,4,-1,lelena (智慧之神-透特),"[問卦] 大家前兩年賺的,還是屌打今年賠的吧?",Sun Jul  3 10:25:59 2022
10,3,7,pilor (Formosa),[問卦] 買重機的好處在哪?,Sun Jul  3 10:43:26 2022
26,4,22,Luckmeow (meow),[新聞] 猴痘發作「癢爆劇痛」根本睡不著！他揭崩,Sun Jul  3 10:37:29 2022
0,0,0,honkwun (反皮草 拒絕血腥時尚),Re,Sun Jul  3 11:36:03 2022
6,0,6,bigtreelife (Tree),[問卦] 屋奴、孩奴那個苦？,Sun Jul  3 09:51:09 2022
2,4,-2,FanFan123 (梵梵),[問卦] 還有人在看金曲獎？,Sun Jul  3 01:39:53 2022
2,4,-2,Ommmmmm5566 (有人責備我們不夠深入),[問卦] 女友演舞台劇被內定刷掉==+,Sun Jul  3 00:02:08 2022
12,1,11,asppsa (橘子綠了),[新聞] 高雄連鎖麵包店無預警歇業！顧客付錢訂,Sun Jul  3 08:00:06 2022
5,1,4,moai513 (523),[問卦] 不經思考 第一想到漢堡是哪家?,Sun Jul  3 11:42:13 2022
8,4,4,qazwsx1029 (含巨大長莖),[問卦] 怎麼停紅燈最安全（認真問卦）,Sun Jul  3 08:08:02 2022
10,1,9,z753951zxc (這是ID),[新聞] 苗21線坍了！癌婦送醫受阻不治　南庄神,Sun Jul  3 09:57:39 2022
0,2,-2,AstrayKnight (牽小白兔看月光的大黑熊),Re,Sun Jul  3 00:40:48 2022
5,1,4,SeaForest (~海森林~),[問卦] 有A級黑豬肉的八卦嗎？,Sat Jul  2 23:15:48 2022
6,2,4,OPPAISuki (OPPAISuki),[問卦] 金曲粉是沒有網路不會看YT嗎?,Sun Jul  3 00:19:41 2022
26,6,20,ckpioneer (風),[新聞] 長髮辣妹打新冠疫苗狂掉髮！「電扇都不,Sun Jul  3 08:07:15 2022
45,14,31,syearth (sysearth),[問卦] 金馬 金曲什麼時候變成小眾 取暖的典禮?,Sun Jul  3 09:50:55 2022
21,12,9,Sevorlaga (【斯佛拉加】。),[問卦] 台灣中國的定局...為什麼不能用談的 (?),Sun Jul  3 07:58:09 2022
2,0,2,kerkerson (高處不勝寒),Re,Sun Jul  3 04:01:36 2022
4,1,3,k99t (聖誕小雞),[問卦] 有沒有眼睛被矇起來多恐懼的八卦？,Sat Jul  2 23:08:13 2022
3,1,2,syearth (sysearth),[新聞] 「弱弱相殘」孫弒癱嬤 思覺失調判3年半,Sun Jul  3 09:35:00 2022
6,1,5,saobox (刀劍神域盒盒),[問卦] 緊緊相依的心如何say goodbye?,Sun Jul  3 02:51:58 2022
9,9,0,DOOHDLIHC (董事長),[問卦] DCARD為什麼一直在黑國動阿,Sun Jul  3 02:59:22 2022
11,1,10,b08297 (),[問卦] 推特上的妹子抖內真的能約嗎,Sun Jul  3 02:47:59 2022
6,0,6,Q00863 (阿棋),[問卦] 柯南劇場版其實是城市景點工商巨片？,Sun Jul  3 11:40:08 2022
6,2,4,Julian9x9x9 (朱利安999),Re,Sun Jul  3 03:57:17 2022
13,16,-3,kukulee (),[新聞] 斯文男友「床上反差」驚呆她　女網友：無,Sun Jul  3 10:43:00 2022
3,1,2,iou861007 (中壢金城武),[問卦] 你說決定錯了無所謂？,Sun Jul  3 01:58:39 2022
13,6,7,ilovemami (聯主簿一一九兵衛教主),[問卦] 現在的老泰森要是遇到電梯夾89會怎樣,Sun Jul  3 07:40:23 2022
13,0,13,lucifa38 (夢中與誰相見),Re,Sat Jul  2 23:10:29 2022
3,4,-1,Rshstudio (屁孩),[問卦] 大家吃芒果的時候會吃芒果籽嗎,Sat Jul  2 23:56:39 2022
100,16,84,kuma525566 (毛怪),[問卦] 完全沒有機車的台灣會是什麼樣子?,Sun Jul  3 09:19:08 2022
4,0,4,secret1414 (我願當你的R20),Re,Sun Jul  3 00:34:08 2022
3,5,-2,oz5566 (阿萊克修斯),Re,Sun Jul  3 10:22:38 2022
9,0,9,chun0303 (chun),[新聞] 高捷黃線招標 啟動捷運路網升級  ,Sun Jul  3 10:42:00 2022
7,0,7,leepingyo (御前一品帶刀龍侍衛),[新聞] 認球隊不可能贏英超下賽季冠軍　C羅向曼,Sun Jul  3 10:19:10 2022
2,1,1,ivorysoap (ivorysoap),[問卦] 抖音應該可以自己辦一個抖音金曲獎吧？,Sun Jul  3 08:57:33 2022
6,3,3,metallican (鋼鐵人),[問卦] 下水道有人訂披薩怎麼辦,Sun Jul  3 08:02:11 2022
12,2,10,aft7795 (Yang),[問卦] 女友：跟前任只是家人的關係，是什麼意思,Sat Jul  2 23:17:15 2022
6,2,4,k44754 (9527),[問卦] 八卦肥肥半夜都會買啥乞丐珍食？？,Sun Jul  3 00:47:40 2022
3,1,2,miyukiandmay (小u),[問卦] 蕭亞軒&楊謹華,Sat Jul  2 23:43:14 2022
7,0,7,Yenfu35 (廣平君),Re,Sat Jul  2 23:56:47 2022
2,3,-1,kohanchen (kohanchen),[問卦] 肥宅很愛穿女裝有扣分嗎？,Sun Jul  3 00:11:46 2022
10,7,3,Usayhiisayha (*＠你說Hi 我說ㄏㄚˋ＠*),[問卦] 所以馬念先跟大淵是有什麼仇？,Sun Jul  3 00:20:53 2022
20,12,8,poeta (鍵盤詩人),[新聞] 烏克蘭知名媒體人：台烏該建立關係了！,Sun Jul  3 11:45:26 2022
4,0,4,seand8088503 (あいうえお),[問卦] PO股票和虛擬貨幣對帳單的人少很多？,Sun Jul  3 08:47:59 2022
5,0,5,s10130804 (台北觀察家),Re,Sun Jul  3 08:36:33 2022
4,0,4,assa9647 (洨書童),[問卦] 最頂的鹹豆漿,Sun Jul  3 10:17:10 2022
3,1,2,fatalabc (...),Re,Sun Jul  3 10:52:33 2022
15,0,15,sukiya (sukiya),[新聞] 小琉球機車大隊注意了 未戴安全帽1天取締,Sun Jul  3 07:34:49 2022
7,0,7,nissan168 (pingGO),[問卦] 中東產油國在悶聲發大財嗎？,Sun Jul  3 08:10:27 2022
2,0,2,IslamicState (伊斯蘭國-不亂砍頭),[問卦] 人生消極掰是強哥演自己嗎,Sun Jul  3 01:08:31 2022
12,0,12,askemm (K.K.),[新聞] 烏克蘭在盧州的最後大城利西昌斯克已淪陷,Sun Jul  3 11:44:00 2022
15,3,12,b33 (Bini the bunny),[新聞] 「顧小孩壓力大」阿嬤跑去樂園玩 日2歲女,Sun Jul  3 11:10:35 2022
0,0,0,AV5566 (射即是空),[問卦] 要怎麼說服正妹同事讓我載？,Sun Jul  3 11:54:46 2022
10,0,10,tobbaco (tobbaco),Re,Sun Jul  3 09:01:42 2022
8,0,8,k44754 (9527),[新聞] 首例猴痘男最新病況曝！5QA搞懂「高危傳,Sun Jul  3 11:22:12 2022
6,5,1,Ximcra ( ),[問卦] 士兵男孩帥到炸怎麼辦,Sun Jul  3 10:06:46 2022
14,2,12,monarch0301 (席哈),Re,Sun Jul  3 09:27:25 2022
46,2,44,aa44 (享受被噓的快感),[新聞] 111年第6梯次志願士兵即日起受理報名,Sun Jul  3 10:23:49 2022
4,1,3,justice2008 (    ),[問卦] 強震前 地磁會異常是真的嗎???,Sun Jul  3 07:19:14 2022
13,1,12,tamama000 (GrandFatHouse崇皇肥肥),[問卦] 10元的餅乾是能吃膩,Sun Jul  3 07:24:50 2022
3,0,3,gg0815 (O0O0O0O0O0O0O0),[問卦] 荔枝有蟲蟲腫抹辦,Sun Jul  3 02:28:38 2022
9,6,3,renna038766 (微積分好難過),[問卦] 現在音樂歧視鏈怎麼排？,Sun Jul  3 11:25:35 2022
1,4,-3,yqhyou (minstrel),[問卦] 南支那為什麼現在不閙分裂獨立？,Sun Jul  3 07:57:07 2022
7,1,6,autokey (該起床啦),[問卦] 提不起勁追金曲獎是何心態的八卦?,Sun Jul  3 00:36:28 2022
4,0,4,maikez (無敵鐵金剛),[新聞] 雙颱過門不入 吳德榮：周四前防劇烈天氣,Sun Jul  3 07:56:58 2022
0,4,-4,parkinque (英文老師),Re,Sat Jul  2 23:36:09 2022
13,1,12,iPadProPlus (哀配之神),[問卦] 柯南飛車衝過雙子星有多震撼？,Sun Jul  3 09:40:07 2022
84,8,76,ClownT (克朗),[問卦] 9m88這金曲表演可打幾分？,Sat Jul  2 23:13:53 2022
5,2,3,GA389434 (GA389434),[問卦] 孤單的時候會想起誰的八卦,Sun Jul  3 01:34:49 2022
0,0,0,spirit119 (一二三木頭人),[問卦] 撕裂族群的歌怎麼可以得獎????,Sat Jul  2 23:11:52 2022
9,1,8,newwer (Jesse Pinkman),[問卦] 一直說自己母胎單身的女生有啥用意?,Sun Jul  3 01:26:22 2022
0,2,-2,thelittleone (うそつき),[問卦] 親俄愛烏不可行嗎？,Sun Jul  3 11:46:53 2022
40,5,35,sqin (台中動物園輪班工讀生),[問卦] 熊貓圓寶兩歲了 蛋糕好吃嗎?? (發錢),Sun Jul  3 08:33:13 2022
9,5,4,gracew0709 (安柏ㄦ),[問卦] 可以給另一半看手機嗎,Sun Jul  3 02:28:42 2022
39,0,39,postit (擁有秘密是快樂的事),Re,Sat Jul  2 23:50:54 2022
1,3,-2,xzcb2008 (可愛老娘變態貓貓=.=),Re,Sun Jul  3 08:57:39 2022
37,5,32,AKATSKI ( ),[問卦] 政府在幫防疫旅館賺錢?,Sun Jul  3 10:39:34 2022
9,4,5,smallGGgirl (ㄏㄏ),[問卦] 健身房是不是很好賺？,Sun Jul  3 10:22:16 2022
7,1,6,nonnon (にゃんぱすー),[問卦] 有沒有越南的喃文的八卦？,Sun Jul  3 00:58:18 2022
3,3,0,sodistrues (true),[問卦] 金曲歌王周杰倫作曲超越麥可傑克森？,Sun Jul  3 10:01:46 2022
3,2,1,goodbye (我想睡覺),[問卦] 20多年前卡拉雞腿堡的肉吃起來比較好吃?,Sun Jul  3 01:19:21 2022
23,12,11,henin2003 (),Re,Sun Jul  3 02:45:49 2022
1,0,1,jack97256 (雪芙第一),[問卦] 羅時豐坐在膠囊上面是不是超猛的,Sat Jul  2 23:41:48 2022
7,0,7,plutox (網路上的芳鄰),[問卦] 黎明之前只要和你盡情嘻嘻？,Sun Jul  3 02:21:28 2022
5,0,5,bluebluelan (鈴谷のあまあま写生管理),Re,Sun Jul  3 03:12:37 2022
8,5,3,showwin (世界一か? 死か?),[問卦] Line有幾個好友才算邊緣人？,Sun Jul  3 09:13:52 2022
5,0,5,srwcc (老馬),[問卦] 為什麼女孩子拍照容易拍到大腿,Sun Jul  3 07:29:20 2022
7,5,2,hipmyhop (pttghetto),[問卦] 柬埔寨詐騙集團,Sun Jul  3 01:36:56 2022
4,2,2,ZengMaktub (YOYOMAK),[問卦] 上班族住台北一個月能存多少？,Sat Jul  2 23:22:33 2022
5,8,-3,szeretlek945 (夜夜夜夜),[問卦] Re,Sun Jul  3 07:54:02 2022
1,0,1,DarkHolbach (垃圾),Re,Sun Jul  3 11:24:33 2022
9,5,4,yolosiku (948794狂),[新聞] 最佳女歌手最佳專輯跟年度專輯,Sat Jul  2 23:51:53 2022
3,3,0,KasmirLo (科科科~),[問卦] 克倫威爾走錯哪步,Sat Jul  2 23:59:14 2022
13,3,10,qphone (老衲柯學家),[問卦] 中國人現在人口數只有10億？,Sun Jul  3 02:14:16 2022
46,0,46,kinjk01 (小白),[問卦] 周杰倫的專輯哪一張可以稱為最佳華語專輯,Sun Jul  3 01:56:31 2022
30,1,29,deepdish (Keep The Faith),[新聞] 影片｜槓鈴脫手掉下來　健身男「被對折」,Sun Jul  3 03:23:53 2022
10,1,9,TUMUASHUN (阿雄),[問卦] 早餐吃鹹豆漿有多爽？,Sun Jul  3 06:31:05 2022
10,0,10,jimmy0316 (一吻便顛倒眾生),[問卦] 料理包有甚麼口味好推薦,Sat Jul  2 23:54:59 2022
3,1,2,carcino5566 (致癌物5566),Re,Sun Jul  3 00:23:14 2022
6,0,6,BigMacGCB (尊重友善包容),[問卦] 大家最近的YT最常出現甚麼廣告,Sun Jul  3 01:17:59 2022
2,0,2,qwaszx012 (天黑黑),[問卦] 這個什麼蕭的頒獎人是誰阿,Sat Jul  2 23:16:18 2022
1,6,-5,zephyr105 (跳跳),[問卦] 愛情是啥模樣 蛤,Sun Jul  3 04:07:26 2022
1,1,0,Dukkha (Anagami),[問卦] 索爾 愛與雷霆 sweet child o’ mine,Sun Jul  3 02:14:15 2022
45,12,33,zo6al (我書讀得少 你不要騙我),[問卦] 宜花東的民宿價格比肩飯店是正常的嗎？,Sun Jul  3 05:57:39 2022
11,0,11,fox1234 (肥宅叛徒),[問卦] 長得醜宅貌的男生怎麼交女友,Sun Jul  3 01:42:27 2022
6,0,6,zzzz8931 (宅男),[問卦] 香港北角是個怎麼樣的地方？,Sun Jul  3 10:26:11 2022
46,4,42,merchape (摸卻普),[新聞] 27年沒請過假！公司送他原子筆、杯子 網,Sun Jul  3 10:58:37 2022
106,10,96,whiteadam (blue eyes blue),[問卦] 阿辰師是不是滿厲害的?,Sun Jul  3 02:01:46 2022
6,0,6,felixr0123 (felixr0123),[問卦] 猴痘跟他的產地會是健身房嗎？,Sun Jul  3 10:59:51 2022
13,1,12,zakijudelo (Zack),[問卦] 二姊江蕙的代表作，你會選哪一首歌,Sun Jul  3 10:24:45 2022
14,0,14,Hsins (迅雷不及掩耳盜鈴),[問卦] 有幾間厝 用磚仔砌？,Sun Jul  3 01:20:35 2022
2,2,0,pulagu (阿杜),[新聞] 習近平「關愛」香港青年 分析：港青對中共,Sun Jul  3 00:41:32 2022
18,15,3,assassinASHE (幹古專用帳號),Re,Sun Jul  3 03:04:44 2022
19,1,18,seabox (呂雅筑),[問卦] 為啥蔡崇信過的比馬雲爽？,Sun Jul  3 01:45:49 2022
1,0,1,Kimmy (Kimi),[問卦] 鄉民笑大戶4在笑什麼?,Sun Jul  3 00:05:51 2022
4,5,-1,pptsuck (whip),[問卦] 請問這是重機仔的新招嗎....？,Sun Jul  3 10:13:07 2022
3,6,-3,ckpioneer (風),Re,Sun Jul  3 06:08:44 2022
8,4,4,wer50888 (逢甲陳柏霖),[問卦] 一款老遊戲,Sun Jul  3 08:49:05 2022
8,1,7,dodo52woman (嘟嘟左右衛門),[問卦] 新住民二代被當原住民，心裡怎麼想？,Sun Jul  3 10:14:03 2022
9,10,-1,jackymars5 ((                )),[問卦] 請問如果這長相能把到妹嗎,Sun Jul  3 07:02:59 2022
6,6,0,algebraic (algebraic),[問卦] 深夜的八卦板 是寂寞邊界嗎,Sun Jul  3 01:24:00 2022
7,0,7,cutiehoneyzu (McHilo),[問卦] 對電資畢業生考國考國營CP值很低吧,Sun Jul  3 09:05:57 2022
0,0,0,op840906 (LOVEISFOURLETTERSWORS),[問卦] 不吃早餐484很健康的事？,Sun Jul  3 11:56:02 2022
0,0,0,silver5566 (吟五六),[問卦] 捍衛戰士摔掉的飛機都怎處理？,Sun Jul  3 11:59:55 2022
23,0,23,LEDG (雪),[問卦] 林宥嘉娶到丁文琪，是不是賺到,Sun Jul  3 00:05:15 2022
2,6,-4,neo5277 (I am an agent of chaos),[問卦] 有沒有三年後的後天的卦,Sun Jul  3 04:24:16 2022
3,0,3,ilovetaida (TAIDA),[問卦] 台灣有錢人流行拿什麼雙重國籍?,Sun Jul  3 10:49:18 2022
52,24,28,nightwing (夏日浮雲),[新聞] 不爽小S具俊曄洗版熱搜 中國小粉紅飆罵：,Sun Jul  3 08:20:39 2022
8,28,-20,shrink5566 (心理師我難過),[問卦] 頑童的胖子為什麼要搞馬念先,Sat Jul  2 23:45:43 2022
18,4,14,peterlin495 (專業果粉O'_'O),[新聞] 台北國際成人展回來了！　D槽女神隔海嬌,Sat Jul  2 23:59:13 2022
0,0,0,man790810 (逢甲李鍾碩),Re,Sun Jul  3 11:43:41 2022
5,1,4,Rshstudio (屁孩),[問卦] 請問「我錯了」算道歉嗎,Sat Jul  2 23:44:16 2022
13,7,6,tudo0430 (可愛いは正義であり！),[問卦] 台灣被網路罷凌最嚴重的人是誰！？,Sat Jul  2 23:41:54 2022
186,5,181,TimYu930218 (凱哥),[問卦] 認真問 金曲26歌手是不是歷屆最大咖？(,Sat Jul  2 23:20:33 2022
8,0,8,b122771 (躺平的韭菜),[問卦] 內湖工程師的血液比較香嗎？,Sun Jul  3 11:46:18 2022
10,1,9,ZengMaktub (YOYOMAK),[問卦] 買手機有人在看CPU效能的嗎,Sun Jul  3 08:55:20 2022
4,5,-1,sweet79731 (),[問卦] 重機上國道 汽車駕駛人非故意不罰,Sun Jul  3 10:34:07 2022
15,12,3,words2012 (づ′・ω・),"[問卦] 帶女友去彰化用膳,是不是很棒!",Sun Jul  3 03:45:13 2022
2,3,-1,archie403 (李奧納多的老公^Q^),[問卦] 今天怎麼突然出現一堆怪人名==,Sun Jul  3 00:40:38 2022
1,0,1,cutenobear (souvenir),[問卦] 領獎致詞,Sat Jul  2 23:10:25 2022
8,0,8,LMCgadra (嘎抓),[問卦] 有人沒追金曲的嗎？,Sun Jul  3 00:33:40 2022
65,18,47,bluehttp (公鯊小),[新聞] 愛莉莎莎又買房！3年繳完「近8百萬房貸」,Sun Jul  3 09:51:06 2022
1,1,0,aivxg (家裡窮西索XD),[問卦] 沒人發現自助餐店員都是阿姨？,Sun Jul  3 10:43:47 2022
0,0,0,b777300 (su35s),[問卦] 請問農漁產品借牌銷售，符合國際規範嗎？,Sun Jul  3 11:59:57 2022
5,0,5,wahaha23 (請勿拍打餵食),[新聞] 英超》周薪35萬英鎊　薩拉續約利物浦效力,Sat Jul  2 23:26:24 2022
2,4,-2,ivon852 (內容農場殺手),[爆卦] 10億中國人隱私資料洩漏,Sun Jul  3 02:34:16 2022
5,2,3,gk1329 (),Re,Sun Jul  3 10:07:03 2022
65,12,53,ae034 (gone with wind),[新聞] 請支援石斑！國防部採購1548公斤　國軍要,Sun Jul  3 11:20:43 2022
6,1,5,tw30912 (tw30912),[問卦] 跟著流浪貓就有東西吃？,Sun Jul  3 10:02:27 2022
12,1,11,fur (英國研究真有趣),[新聞] 金曲獎爭議｜頑童頒歌王開玩笑遭公幹「,Sun Jul  3 11:22:09 2022
3,0,3,frzqp3814396 (愛在高端),[問卦] 少拿餐點要不要回去拿？,Sun Jul  3 01:39:29 2022
27,0,27,jasd1786 (假橡膠樹),[問卦] 簽哪一種兵種的志願役可以學到專業？,Sun Jul  3 11:10:21 2022
12,1,11,oz5566 (阿萊克修斯),Re,Sun Jul  3 08:33:04 2022
7,0,7,dhvaja (終於懂了),[新聞]重複確診風險愈來愈高 紐約歌手打了補強,Sun Jul  3 11:41:03 2022
14,2,12,jimmy0316 (一吻便顛倒眾生),[問卦] 幾歲才開始剪鼻毛啊,Sun Jul  3 00:26:28 2022
5,2,3,tsisni (努力步上軌道),[問卦] 手機晶片才50美金,Sat Jul  2 23:46:45 2022
2,0,2,hayate232 (CY),Re,Sun Jul  3 04:02:17 2022
24,2,22,IhateOGC (我討厭),[問卦] 早餐店真的那麼好賺？,Sun Jul  3 05:55:05 2022
46,17,29,james7923 (詹姆士Q),[新聞] 高雄版虎媽！4歲童不聽話遭趕下車　趴窗,Sun Jul  3 11:22:17 2022
0,0,0,Lineage097 (狐狸壽司),[問卦] 10中快攻要怎麼打回去？,Sun Jul  3 00:14:15 2022
1,0,1,lotudi (母湯仁~阿肥震傳~),[問卦]  休假前一晚超不想洗澡？,Sat Jul  2 23:15:43 2022
2,6,-4,johanLarson (Rent),[問卦] 中國人：這東西咱們祖國也有！,Sun Jul  3 00:35:49 2022
19,5,14,chocopie (好吃的巧克力派 :)),[問卦] 師大墜樓 vs 問音響 聲量差好多,Sun Jul  3 10:15:41 2022
9,1,8,jokerming847 (God of Mischief),[問卦] 欸！8+9有沒有優點可以說嘴的？,Sun Jul  3 00:25:24 2022
4,2,2,gishileh (三結義市xx局長下台!),[問卦] 唱衰自己的人最可怕吧?,Sun Jul  3 10:15:05 2022
8,0,8,cj4385283 (Linhi),[問卦] 龍山寺底下搞文創？幹嘛不用成性專區,Sun Jul  3 10:43:59 2022
5,2,3,yoga5566 (宥嘉5566),Re,Sun Jul  3 09:23:22 2022
11,2,9,skn60694 (入聲),[新聞] 水田躺著「長歪小西瓜」超神秘！　萌萌身,Sun Jul  3 11:22:26 2022
3,0,3,sofaly (沙發椅),Re,Sun Jul  3 09:24:00 2022
3,1,2,iou861007 (中壢金城武),[問卦] 沒有環景不會開車怎麼辦？,Sun Jul  3 10:13:46 2022
10,10,0,man790810 (逢甲李鍾碩),[問卦] 重機為什麼要上國道,Sun Jul  3 10:56:50 2022
76,18,58,linda17a3 (),[新聞] 北市百齡橋恐怖車禍 肇事駕駛高速撞2車釀,Sun Jul  3 07:37:21 2022
1,0,1,postit (擁有秘密是快樂的事),Re,Sat Jul  2 23:07:27 2022
14,4,10,xuein (脫線烏賊),[新聞] 人妻嬌羞連結老同學！他爽喊：射滿妳　,Sun Jul  3 11:21:20 2022
5,1,4,ttn851227 (beyond218),[問卦] 花錢性交+攝影=拍a片,Sat Jul  2 23:12:32 2022
0,0,0,ivan1994 (ILanHeungMinSon),[新聞] 超噁阿伯酒精噴鼻孔！正妹店員看傻,Sun Jul  3 11:53:57 2022
17,7,10,docose (風華之語),[新聞] 烏克蘭擊退頓巴斯俄軍,Sun Jul  3 10:13:56 2022
14,2,12,tavern (我要早點洗澡),[問卦] 蕭亞軒的鼻子怎麼了,Sat Jul  2 23:16:22 2022
4,4,0,samlin92303 ( mimic),[問卦] 金曲獎是不是台灣版SJW,Sun Jul  3 10:20:13 2022
9,2,7,Hanedas (),[問卦] 又帥又有錢 可是被關過女生還會愛嗎,Sat Jul  2 23:36:56 2022
